04,04,00,01,02,03,04,05,06,06,06,06,07,08,09,10,11,11,12,09,13,14,04,00,01,02,90,02
04,04,00,01,02,03,04,15,11,11,11,11,16,17,09,18,19,20,21,09,22,23,24,00,01,02,90,02
04,04,00,01,02,03,04,25,26,27,28,29,30,31,11,32,33,34,35,11,36,37,38,00,01,02,90,02
94,95,00,01,02,03,39,40,41,42,43,44,45,46,47,48,49,50,51,47,52,53,04,00,01,02,90,02
93,04,00,01,02,03,04,54,55,56,57,58,59,60,61,62,63,64,65,61,66,04,04,00,01,02,90,02
92,04,67,69,70,68,04,04,04,04,04,04,04,04,04,04,04,04,04,04,04,04,04,00,01,02,90,02
71,71,72,01,02,73,71,71,71,71,71,71,71,71,71,71,71,71,71,71,71,71,71,72,01,02,90,02
74,75,76,77,78,79,74,80,81,81,81,81,74,75,81,81,81,81,81,81,81,74,75,76,82,83,83,83
84,85,86,86,86,86,84,85,86,86,86,86,84,85,86,86,86,86,86,86,86,84,85,86,86,86,86,86
89,87,88,88,88,88,89,87,88,88,88,88,89,87,88,88,88,88,88,88,88,89,87,88,88,88,88,88
91,91,91,91,91,91,91,91,91,91,91,91,91,91,91,91,91,91,91,91,91,91,91,91,91,91,91,91
04,04,04,04,04,04,04,04,04,04,04,04,04,04,04,04,04,04,04,04,04,04,04,04,04,04,04,04
04,04,04,04,04,04,04,04,04,04,04,04,04,04,04,04,04,04,04,04,04,04,04,04,04,04,04,04
04,04,04,04,04,04,04,04,04,04,04,04,04,04,04,04,04,04,04,04,04,04,04,04,04,04,04,04
04,04,04,04,04,04,04,04,04,04,04,04,04,04,04,04,04,04,04,04,04,04,04,04,04,04,04,04
04,04,04,04,04,04,04,04,04,04,04,04,04,04,04,04,04,04,04,04,04,04,04,04,04,04,04,04
1,1,1,1,1,1,1,1,0,0,0,0,0,0,0,0,0,0,0,0,0,1,0,0,0,0,0,0
1,0,0,0,0,0,0,1,0,0,0,0,0,0,0,0,0,0,0,0,0,1,0,0,0,0,0,0
1,0,0,0,0,0,0,1,0,0,0,0,0,0,0,0,0,0,0,0,0,1,1,1,1,0,0,0
1,0,0,0,0,0,0,1,0,0,0,0,0,0,0,0,0,0,0,0,0,1,0,0,1,0,0,0
1,0,0,0,0,0,0,1,1,1,1,1,1,1,1,1,1,1,1,1,1,0,0,0,1,0,0,0
1,0,0,0,0,0,0,0,0,0,0,0,0,0,0,0,0,0,0,0,0,0,0,0,1,0,0,0
1,0,0,0,0,0,0,0,0,0,0,0,0,0,0,0,0,0,0,0,0,0,0,0,1,0,0,0
1,0,0,0,0,0,0,0,0,0,0,0,0,0,0,0,0,0,0,0,0,0,0,0,1,0,0,0
1,0,0,0,0,0,0,0,0,0,0,0,0,0,0,0,0,0,0,0,0,0,0,0,1,0,0,0
1,0,0,0,0,0,0,0,0,0,0,0,0,0,0,0,0,0,0,0,0,0,0,0,1,0,0,0
1,0,0,0,0,0,0,0,0,0,0,0,0,0,0,0,0,0,0,0,0,0,0,0,1,0,0,0
1,0,0,0,0,0,0,0,0,0,0,0,0,0,0,0,0,0,0,0,0,0,0,0,1,0,0,0
1,0,0,0,0,0,0,0,0,0,0,0,0,0,0,0,0,0,0,0,0,0,0,0,1,0,0,0
1,0,0,0,0,0,0,0,0,0,0,0,0,0,0,0,0,0,0,0,0,0,0,0,1,0,0,0
1,0,0,0,0,0,0,0,0,0,0,0,0,0,0,0,0,0,0,0,0,0,0,0,1,0,0,0
1,1,1,1,1,1,1,1,1,1,1,1,1,1,1,1,1,1,1,1,1,1,1,1,1,0,0,0